0 0 0 0 0 0 0 0 0 0 0 0
0 T T T T B B B B B B B
0 0 W W 0 B 0 0 0 0 0 0
0 0 0 W 0 0 0 0 0 0 0 0
0 0 0 W 0 0 0 T P 0 0 0
0 0 0 W 0 0 0 0 0 0 0 0
0 0 0 S S S S B S S 0 0
S S 0 0 0 0 0 0 0 0 0 0
0 0 0 0 0 0 0 0 0 0 0 0
0 0 0 0 0 W W S S W W W
S S S 0 0 0 0 0 0 0 0 0
0 0 0 0 0 0 0 0 0 0 0 0